地图数据格式：
	(0)“@”表示一个地图数据块的开始标记。
	(1)地图大小：宽W 高H。
	(2)方块初始坐标X Y。
	(2)方块终点坐标X Y。
	(3)地图数据:1有方块 0无方块。
备注:
	1.请严格按照上述格式编写地图。
	2.注释只能出现在上一个地图结束后和下一个地图“@”开始前。
	3.地图大小尽量不要超过20*10。
	
欢迎各位补充高质量地图！

@
11 7
2 1
10 5
1 1 1 1 0 0 0 0 0 0 0 
1 1 0 1 1 0 0 0 0 0 0
1 1 0 1 1 0 0 0 0 0 0
0 0 0 0 1 1 1 0 1 1 1
0 0 0 0 0 1 1 1 1 1 1
0 0 0 0 0 0 0 0 1 1 1
0 0 0 0 0 0 0 0 0 1 1


@
6 6
1 1
5 5 
1 0 0 0 0 0
1 1 1 1 0 0
1 1 1 1 1 0
0 0 0 1 1 1
0 0 0 1 1 1
0 0 0 1 1 1

@
11 6
1 1
10 2
1 1 1 1 1 0 0 0 1 1 1
1 1 1 1 1 0 1 1 1 1 1
1 1 0 0 1 1 1 1 1 1 1
0 1 1 0 1 1 1 0 1 1 1
1 1 1 1 1 1 0 0 1 1 0
0 1 1 1 1 1 0 0 1 0 0


@
13 6
1 1
11 2
1 1 1 1 0 0 0 0 0 1 1 1 0
0 0 0 1 0 0 0 0 1 1 1 1 1
0 1 1 1 0 1 1 1 1 0 1 1 1
0 1 1 1 0 1 1 0 1 1 1 1 0
0 0 1 1 0 1 1 0 1 1 1 0 0
0 0 0 1 1 1 1 0 0 0 0 0 0


@
12 6
2 1
11 4
1 1 1 0 0 0 0 0 0 0 0 0 
1 1 1 1 1 0 0 0 0 0 0 0
1 1 1 0 1 0 0 0 0 1 1 0
1 0 0 0 1 1 1 0 0 1 1 1
1 0 0 0 0 1 1 1 1 1 1 1
1 1 1 1 1 1 1 1 0 1 1 1



@
9 6
3 2
8 2
0 0 0 0 0 1 1 1 1
1 1 1 0 0 1 1 1 1
1 1 1 0 0 1 1 1 1
1 1 1 0 0 0 1 0 0
0 1 1 0 1 1 1 0 0
0 1 1 1 1 1 0 0 0

@
11 9
1 4
6 7
0 0 0 1 1 1 1 1 0 0 0
0 0 0 1 0 0 1 1 0 0 0
0 0 0 1 1 0 1 1 0 0 0
1 1 1 1 1 0 0 1 1 1 1 
0 0 0 0 1 0 0 0 1 1 1 
0 0 0 1 1 1 1 1 0 1 1
0 0 0 1 1 1 1 1 1 1 1
0 0 0 1 1 1 0 1 1 1 0
0 0 0 1 1 1 0 1 1 1 0

欢迎各位补充高质量地图！